XAL = "countries/DEN_USA/XAL.txt"
XAZ = "countries/DEN_USA/XAZ.txt"
XAR = "countries/DEN_USA/XAR.txt"
XCA = "countries/DEN_USA/XCA.txt"
XCO = "countries/DEN_USA/XCO.txt"
XFL = "countries/DEN_USA/XFL.txt"
XGA = "countries/DEN_USA/XGA.txt"
XIL = "countries/DEN_USA/XIL.txt"
XIN = "countries/DEN_USA/XIN.txt"
XIA = "countries/DEN_USA/XIA.txt"
XKS = "countries/DEN_USA/XKS.txt"
XKY = "countries/DEN_USA/XKY.txt"
XLA = "countries/DEN_USA/XLA.txt"
XID = "countries/DEN_USA/XID.txt"
XMD = "countries/DEN_USA/XMD.txt"
XMN = "countries/DEN_USA/XMN.txt"
XMS = "countries/DEN_USA/XMS.txt"
XMO = "countries/DEN_USA/XMO.txt"
XMT = "countries/DEN_USA/XMT.txt"
XNE = "countries/DEN_USA/XNE.txt"
XNV = "countries/DEN_USA/XNV.txt"
XNJ = "countries/DEN_USA/XNJ.txt"
XNM = "countries/DEN_USA/XNM.txt"
XNY = "countries/DEN_USA/XNY.txt"
XNC = "countries/DEN_USA/XNC.txt"
XND = "countries/DEN_USA/XND.txt"
XOH = "countries/DEN_USA/XOH.txt"
XOK = "countries/DEN_USA/XOK.txt"
XOR = "countries/DEN_USA/XOR.txt"
XPA = "countries/DEN_USA/XPA.txt"
XSC = "countries/DEN_USA/XSC.txt"
XSD = "countries/DEN_USA/XSD.txt"
XTN = "countries/DEN_USA/XTN.txt"
XTX = "countries/DEN_USA/XTX.txt"
XUT = "countries/DEN_USA/XUT.txt"
XVA = "countries/DEN_USA/XVA.txt"
XWA = "countries/DEN_USA/XWA.txt"
XWV = "countries/DEN_USA/XWV.txt"
XWI = "countries/DEN_USA/XWI.txt"
XWY = "countries/DEN_USA/XWY.txt"
XNN = "countries/DEN_USA/XNN.txt"
